{
  "1": {
    "ambient": {
      "color":	  	[0.25, 0.25, 0.25, 0.25],
      "gamma":		true,
      "diffuse":	true,
      "blur":
    },
    "tiles": {
      "type" : "land",
      "layout":
       [[2, 4, 4, 2, 3, 2, 3,  1,1,1],
        [1, 4, 4, 1, 1, 2, 3, 1,3,1],
        [1, 4, 4, 4, 4, 4, 4, 4,4,4],
        [2, 4, 4, 4, 4, 4, 4, 4,1,1],
        [1, 1, 3, 1, 3, 2, 1, 3,2,1],
        [1, 3, 1, 2, 1, 2, 1, 2,3,3],
        [1, 1, 1, 3, 4, 4, 4, 4,4,4],
        [1, 2, 2, 1, 1, 2, 2, 1,1,1],
        [3, 4, 4, 3, 3, 4, 4, 3,3,3],
        [1, 1, 1, 1, 1, 1, 1, 1,1,1]]
    },
    "scene": {
      "player": [1, 2],
      "enemies": [
        {
          "type": "villager",
          "position": [3, 3],
          "patrol": [[3, 3]]
        }
      ],
      "objects": {

      },
      "moonlight":
      [[0, 1, 0, 0, 0, 0, 0,  0,0,0],
        [0, 1, 0, 0, 0, 0, 0, 1,1,0],
        [0, 1, 0, 0, 0, 0, 0, 1,0,0],
        [0, 0, 0, 0, 0, 0, 0, 0,0,0],
        [0, 0, 0, 0, 0, 0, 0, 0,0,0],
        [0, 0, 0,0, 0, 0, 0, 0,0,0],
        [0, 0, 0, 0, 0, 0, 0, 0,0,0],
        [0, 0, 0, 1, 0, 0, 0, 0,0,0],
        [0, 0, 0, 1, 0, 0, 1, 0,0,0],
        [0, 1, 1, 1, 0, 0, 0, 0,0,0]]
    }
  }
}