{
  "1": {
    "tiles":
    [[2, 4, 4, 2, 3, 2, 3,  1,1,1],
      [1, 4, 4, 1, 1, 2, 3, 1,3,1],
      [1, 4, 4, 4, 4, 4, 4, 4,4,4],
      [2, 4, 4, 4, 4, 4, 4, 4,1,1],
      [1, 1, 3, 1, 3, 2, 1, 3,2,1],
      [1, 3, 1, 2, 1, 2, 5, 5,5,5],
      [1, 1, 1, 3, 5, 5, 5, 5,5,5],
      [6, 6, 5, 5, 5, 5, 5, 5,5,5],
      [6, 6, 6, 5, 5, 5, 5, 5,5,5],
      [6, 6, 6, 6, 5, 5, 5, 5,5,5]],
    "scene": {
      "player": [1, 2],
      "enemies": [
        {
          "position": [3, 3],
          "patrol": [[3, 4], [3, 5], [3, 6], [3,5]]
        },
        {
          "position": [8,8],
          "patrol": [[8, 7], [8, 6], [8, 5], [8, 4], [8, 5], [8, 6]]
        }
      ],
      "objects": {

      },
      "moonlight":
      [[0, 0, 0, 0, 0, 0, 0,  0,0,0],
        [0, 0, 0, 0, 0, 0, 0, 0,0,0],
        [0, 0, 0, 0, 0, 0, 0, 0,0,0],
        [0, 0, 0, 0, 0, 0, 0, 0,0,0],
        [0, 0, 0, 0, 0, 0, 0, 0,0,0],
        [0, 0, 0,0, 0, 0, 0, 0,0,0],
        [0, 0, 0, 0, 0, 0, 0, 0,0,0],
        [0, 0, 0, 0, 0, 1, 1, 0,0,0],
        [0, 0, 0, 0, 0, 1, 1, 0,0,0],
        [0, 0, 0, 0, 0, 0, 0, 0,0,0]]
    }
  }
}