{
  "1": {
    "tiles":
      [[1, 2, 3, 4, 1, 3, 1,  1,1,1],
        [1, 2, 3, 1, 2, 4, 1, 1,4,4],
        [1, 1, 2, 1, 1, 1, 1, 1,1,4],
        [1, 4, 4, 1, 4, 1, 2, 1,4,1],
        [4, 4, 1, 1, 4, 1, 1, 1,2,2],
        [4, 1, 1, 2, 1, 1, 2, 1,3,2],
        [3, 2, 2, 1, 1, 3, 1, 3,1,1],
        [1, 1, 4, 1, 4, 1, 4, 2,2,2],
        [1, 1, 1, 1, 1, 2, 3, 2,1,1],
        [1, 1, 1, 1, 1, 3, 2, 1,4,3]],
    "scene": {
      "player": [1, 2],
      "enemies": [
        {
          "position": [3, 3],
          "patrol": [[3, 4], [3, 5], [3, 6], [3,5]]
        },
        {
          "position": [8,8],
          "patrol": [[8, 7], [8, 6], [8, 5], [8, 4], [8, 5], [8, 6]]
        }
      ],
      "objects": {

      },
      "moonlight":
      [[1, 1, 1, 1, 1, 1, 1,  1,1,1],
        [1, 1, 1, 1, 1, 1, 1, 1,1,1],
        [1, 1, 0, 1, 1, 1, 1, 0,1,1],
        [1, 1, 1, 0, 1, 1, 0, 1,1,1],
        [1, 1, 1, 1, 0, 0, 1, 1,1,1],
        [1, 1, 1, 1, 0, 0, 1, 1,1,1],
        [1, 1, 1, 0, 1, 1, 0, 1,1,1],
        [1, 1, 0, 1, 1, 1, 1, 0,1,1],
        [1, 1, 1, 1, 1, 1, 1, 1,1,1],
        [1, 1, 1, 1, 1, 1, 1, 1,1,1]]
    }
  }
}