{
  "1": {
    "tiles":
    [[1, 1, 1, 1, 1, 1, 1,  1,1,1],
      [1, 1, 1, 1, 1, 1, 1, 1,1,1],
      [1, 1, 1, 1, 1, 1, 1, 1,1,1],
      [1, 1, 1, 1, 1, 1, 1, 1,1,1],
      [1, 1, 1, 1, 1, 1, 1, 1,1,1],
      [1, 1, 1, 1, 1, 1, 1, 1,1,1],
      [1, 1, 1, 1, 1, 1, 1, 1,1,1],
      [1, 1, 1, 1, 1, 1, 1, 1,1,1],
      [1, 1, 1, 1, 1, 1, 1, 1,1,1],
      [1, 1, 1, 1, 1, 1, 1, 1,1,1]],
    "scene": {
      "player": [1, 2],
      "enemies": [
        {
          "position": [3, 3],
          "patrol": [[3, 4], [3, 5], [3, 6], [3,5]]
        },
        {
          "position": [8,8],
          "patrol": [[8, 7], [8, 6], [8, 5], [8, 4], [8, 5], [8, 6]]
        }
      ],
      "objects": {

      },
      "moonlight":
      [[0, 0, 0, 0, 0, 0, 0,  0,0,0],
        [0, 0, 0, 0, 0, 0, 0, 0,0,0],
        [0, 0, 0, 0, 0, 0, 0, 0,0,0],
        [0, 0, 0, 0, 0, 0, 0, 0,0,0],
        [0, 0, 0, 0, 0, 0, 0, 0,0,0],
        [0, 0, 0,0, 0, 0, 0, 0,0,0],
        [0, 0, 0, 0, 0, 0, 0, 0,0,0],
        [0, 0, 0, 0, 0, 1, 1, 0,0,0],
        [0, 0, 0, 0, 0, 1, 1, 0,0,0],
        [0, 0, 0, 0, 0, 0, 0, 0,0,0]]
    }
  }
}